doctor,0,1,2,3,4,5,6,Всего
Dr. Alex,0,0,0,2,0,3,0,5
Dr. Anna,4,5,67,3,4,6,3,92
Dr. Ben,2,4,39,0,3,1,1,50
Dr. Bob,3,5,55,3,2,4,1,73
Dr. Charlie,1,0,0,0,1,3,0,5
Dr. Quinn,1,0,0,0,1,0,1,3
Dr. Rudy,2,0,0,1,2,0,2,7
Lab,4,6,74,3,4,6,3,100
Nurse Corey,2,4,66,2,6,4,2,86
Nurse Jesse,6,8,82,4,2,8,4,114
Pharmacy,0,6,74,0,0,0,0,80
Team 1,0,0,36,1,1,2,0,40
Team 2,0,0,38,2,3,4,3,50
Всего,25,38,531,21,29,41,20,705
