doctor,0,1,2,3,Всего
Dr. Alex,0,4,0,0,4
Dr. Anna,29,15,4,21,69
Dr. Ben,20,5,3,8,36
Dr. Bob,20,12,3,15,50
Dr. Charlie,0,4,0,0,4
Dr. Quinn,0,2,0,0,2
Dr. Rudy,0,5,0,0,5
Lab,30,15,4,21,70
Nurse Corey,24,14,2,24,64
Nurse Jesse,36,16,6,18,76
Pharmacy,30,0,4,21,55
Team 1,15,3,0,12,30
Team 2,15,9,0,9,33
Всего,219,104,26,149,498
