doctor,0,1,2,3,Всего
Dr. Alex,0,1,0,0,1
Dr. Anna,4,7,2,8,21
Dr. Ben,2,2,1,6,11
Dr. Bob,5,6,1,7,19
Dr. Charlie,0,0,0,1,1
Dr. Quinn,0,1,0,0,1
Dr. Rudy,0,0,1,1,2
Lab,5,9,2,10,26
Nurse Corey,4,6,2,10,22
Nurse Jesse,6,12,2,10,30
Pharmacy,5,7,1,8,21
Team 1,2,4,1,1,8
Team 2,3,4,1,7,15
Всего,36,59,14,69,178
